date,commit_count,unique_committers,lines_added,lines_deleted,total_changes
2011-07-01,0,0,0,0,0
2011-08-01,0,0,0,0,0
2011-09-01,0,0,0,0,0
2011-10-01,0,0,0,0,0
2011-11-01,0,0,0,0,0
2011-12-01,0,0,0,0,0
2012-01-01,0,0,0,0,0
2012-02-01,0,0,0,0,0
2012-03-01,0,0,0,0,0
2012-04-01,0,0,0,0,0
2012-05-01,0,0,0,0,0
2012-06-01,0,0,0,0,0
2012-07-01,0,0,0,0,0
2012-08-01,0,0,0,0,0
2012-09-01,0,0,0,0,0
2012-10-01,0,0,0,0,0
2012-11-01,0,0,0,0,0
2012-12-01,0,0,0,0,0
2013-01-01,0,0,0,0,0
2013-02-01,0,0,0,0,0
2013-03-01,0,0,0,0,0
2013-04-01,0,0,0,0,0
2013-05-01,0,0,0,0,0
2013-06-01,0,0,0,0,0
2013-07-01,0,0,0,0,0
2013-08-01,0,0,0,0,0
2013-09-01,0,0,0,0,0
2013-10-01,0,0,0,0,0
2013-11-01,0,0,0,0,0
2013-12-01,0,0,0,0,0
2014-01-01,0,0,0,0,0
2014-02-01,0,0,0,0,0
2014-03-01,0,0,0,0,0
2014-04-01,0,0,0,0,0
2014-05-01,0,0,0,0,0
2014-06-01,0,0,0,0,0
2014-07-01,0,0,0,0,0
2014-08-01,0,0,0,0,0
2014-09-01,0,0,0,0,0
2014-10-01,0,0,0,0,0
2014-11-01,0,0,0,0,0
2014-12-01,0,0,0,0,0
2015-01-01,0,0,0,0,0
2015-02-01,0,0,0,0,0
2015-03-01,0,0,0,0,0
2015-04-01,0,0,0,0,0
2015-05-01,0,0,0,0,0
2015-06-01,0,0,0,0,0
2015-07-01,0,0,0,0,0
2015-08-01,0,0,0,0,0
2015-09-01,0,0,0,0,0
2015-10-01,0,0,0,0,0
2015-11-01,0,0,0,0,0
2015-12-01,0,0,0,0,0
2016-01-01,0,0,0,0,0
2016-02-01,0,0,0,0,0
2016-03-01,0,0,0,0,0
2016-04-01,0,0,0,0,0
2016-05-01,0,0,0,0,0
2016-06-01,0,0,0,0,0
2016-07-01,0,0,0,0,0
2016-08-01,0,0,0,0,0
2016-09-01,0,0,0,0,0
2016-10-01,0,0,0,0,0
2016-11-01,0,0,0,0,0
2016-12-01,0,0,0,0,0
2017-01-01,0,0,0,0,0
2017-02-01,0,0,0,0,0
2017-03-01,0,0,0,0,0
2017-04-01,0,0,0,0,0
2017-05-01,0,0,0,0,0
2017-06-01,0,0,0,0,0
2017-07-01,0,0,0,0,0
2017-08-01,0,0,0,0,0
2017-09-01,0,0,0,0,0
2017-10-01,0,0,0,0,0
2017-11-01,0,0,0,0,0
2017-12-01,0,0,0,0,0
2018-01-01,0,0,0,0,0
2018-02-01,0,0,0,0,0
2018-03-01,0,0,0,0,0
2018-04-01,0,0,0,0,0
2018-05-01,0,0,0,0,0
2018-06-01,0,0,0,0,0
2018-07-01,0,0,0,0,0
2018-08-01,0,0,0,0,0
2018-09-01,0,0,0,0,0
2018-10-01,0,0,0,0,0
2018-11-01,0,0,0,0,0
2018-12-01,0,0,0,0,0
2019-01-01,0,0,0,0,0
2019-02-01,0,0,0,0,0
2019-03-01,0,0,0,0,0
2019-04-01,0,0,0,0,0
2019-05-01,0,0,0,0,0
2019-06-01,0,0,0,0,0
2019-07-01,0,0,0,0,0
2019-08-01,0,0,0,0,0
2019-09-01,0,0,0,0,0
2019-10-01,0,0,0,0,0
2019-11-01,0,0,0,0,0
2019-12-01,0,0,0,0,0
2020-01-01,0,0,0,0,0
2020-02-01,0,0,0,0,0
2020-03-01,0,0,0,0,0
2020-04-01,0,0,0,0,0
2020-05-01,0,0,0,0,0
2020-06-01,0,0,0,0,0
2020-07-01,0,0,0,0,0
2020-08-01,0,0,0,0,0
2020-09-01,0,0,0,0,0
2020-10-01,0,0,0,0,0
2020-11-01,0,0,0,0,0
2020-12-01,0,0,0,0,0
2021-01-01,0,0,0,0,0
2021-02-01,0,0,0,0,0
2021-03-01,0,0,0,0,0
2021-04-01,0,0,0,0,0
2021-05-01,0,0,0,0,0
2021-06-01,0,0,0,0,0
2021-07-01,0,0,0,0,0
2021-08-01,0,0,0,0,0
2021-09-01,0,0,0,0,0
2021-10-01,0,0,0,0,0
2021-11-01,0,0,0,0,0
2021-12-01,0,0,0,0,0
2022-01-01,0,0,0,0,0
2022-02-01,0,0,0,0,0
2022-03-01,0,0,0,0,0
2022-04-01,0,0,0,0,0
2022-05-01,0,0,0,0,0
2022-06-01,0,0,0,0,0
2022-07-01,0,0,0,0,0
2022-08-01,0,0,0,0,0
2022-09-01,0,0,0,0,0
2022-10-01,0,0,0,0,0
2022-11-01,0,0,0,0,0
2022-12-01,0,0,0,0,0
2023-01-01,0,0,0,0,0
2023-02-01,0,0,0,0,0
2023-03-01,0,0,0,0,0
2023-04-01,24,3,2250,665,2915
2023-05-01,16,3,474,113,587
2023-06-01,0,0,0,0,0
2023-07-01,51,6,1030,230,1260
2023-08-01,53,3,1462,254,1716
2023-09-01,8,4,139,18,157
2023-10-01,16,4,138,19,157
2023-11-01,0,0,0,0,0
2023-12-01,2,2,1,1,2
2024-01-01,0,0,0,0,0
2024-02-01,15,5,55,24,79
2024-03-01,19,6,141,72,213
2024-04-01,12,4,30,16,46
2024-05-01,0,0,0,0,0
2024-06-01,4,2,14,31,45
2024-07-01,6,4,34,5,39
2024-08-01,0,0,0,0,0
2024-09-01,0,0,0,0,0
2024-10-01,8,3,146,65,211
2024-11-01,10,2,158,36,194
2024-12-01,0,0,0,0,0
2025-01-01,2,2,1,1,2
2025-02-01,8,5,34,15,49
2025-03-01,0,0,0,0,0
2025-04-01,0,0,0,0,0
2025-05-01,2,2,1,1,2
2025-06-01,2,2,2,2,4
2025-07-01,8,4,68,50,118
2025-08-01,1,1,3,3,6
2025-09-01,8,2,991,890,1881
2025-10-01,2,2,2,2,4
2025-11-01,0,0,0,0,0
